REFINED HARD G (É¡) CLASSIFICATION REPORT
======================================

ğŸŒ DEFINITE LOANWORDS (KEEP HARD G É¡)
==================================================
arago                     | aË r aË É¡ oË                   | proper_names
archipelago               | É‘ r x i p É› l aË É¡ oË          | geographic_names
bakboord                  | b É‘ É¡ b oË r t                 | nautical_foreign
bakboordszijde            | b É‘ É¡ b oË r t s É›i d É™        | nautical_foreign
bakboordzijde             | b É‘ É¡ b oË r t s É›i d É™        | nautical_foreign
bougainville              | b u É¡ É›Ìƒ v i l                 | proper_names
bouguer                   | b u É¡ w É› r                    | proper_names
cerigo                    | s É™ r i É¡ oË                   | geographic_names
chesapeakbaai             | t Êƒ É› s É‘ p i É¡ b aË j         | nautical_foreign
cingales                  | s Éª Å‹ É¡ eË l s                 | foreign_words
congo                     | k É” Å‹ É¡ oË                     | geographic_names
dugong                    | d Ê É¡ É” Å‹                      | nautical_foreign
farragut                  | f É‘ r aË É¡ Ê t                 | proper_names
gargantua                 | É¡ É‘ r É¡ É™ n t y w aË           | proper_names
gascogne                  | É¡ É‘ s k É” É² É™                  | geographic_names
glasgow                   | x l É‘Ë s É¡ É‘u                  | geographic_names
go                        | É¡ oË                           | foreign_words
graphiet                  | É¡ r É› f i t                    | foreign_words
greenwich                 | É¡ r i n Éª t Êƒ                  | geographic_names
guadeloupe                | É¡ w aË d É™ l u p               | geographic_names
guinea                    | É¡ i n eË j aË                  | geographic_names
gutta                     | É¡ u t aË                       | foreign_words
guyana                    | É¡ w i j aË n aË                | geographic_names
higginson                 | h Éª É¡ Éª n s É” n                | proper_names
hungarian                 | h Ê Å‹ É¡ aË r i j É‘ n           | geographic_names
manga                     | m É‘ Å‹ É¡ aË                     | foreign_words
sargazzo                  | s É‘ r É¡ É‘ t s oË               | nautical_foreign
singalees                 | s Éª Å‹ É¡ eË l i s               | foreign_words
uraguay                   | y r aË É¡ w É‘ j                 | geographic_names
wagner                    | w aË É¡ n É™ r                   | proper_names

ğŸ‡³ğŸ‡± DEFINITE NATIVE DUTCH (CONVERT É¡ â†’ É£)
==================================================
dankbaarheid              | d É‘ Å‹ É¡ b aË r h É›i t          | dutch_compounds
denkbeeld                 | d É› Å‹ É¡ b eË l t               | dutch_compounds
denkbeelden               | d É› Å‹ É¡ b eË l d É™             | dutch_compounds
denkbeeldig               | d É› Å‹ É¡ b eË l d É™ x           | dutch_compounds
denkbeeldige              | d É› Å‹ É¡ b eË l d É™ É£ É™         | dutch_compounds
gelijkbeenige             | x É™ l É›i É¡ b eË n É™ É£ É™        | dutch_compounds
gelijkbeenigen            | x É™ l É›i É¡ b eË n É™ É£ É™        | dutch_compounds
geographischen            | x eË j oË É¡ r É› f i s É™        | dutch_compounds
gephotographeerd          | x É™ p h oË t oË É¡ r É› f eË r t | dutch_compounds
kraakbeenigen             | k r aË É¡ b eË n É™ É£ É™          | dutch_compounds
ondankbaarheid            | É” n d É‘ Å‹ É¡ b aË r h É›i t      | dutch_compounds
rijksdaalder              | r É›i É¡ z d aË l d É™ r          | dutch_compounds
rijksdaalders             | r É›i É¡ z d aË l d É™ r s        | dutch_compounds

ğŸ‡³ğŸ‡± LIKELY NATIVE DUTCH (CONVERT É¡ â†’ É£)
==================================================
drinkbaar                 | d r Éª Å‹ É¡ b aË r               | compound_indicators
kraakbeenachtige          | k r aË É¡ b eË n É‘ x t É™ É£ É™    | compound_indicators
kraakbeenderen            | k r aË É¡ b eË n d É™ r É™        | compound_indicators
laakbare                  | l aË É¡ b aË r É™                | compound_indicators
merkbaar                  | m É› r É¡ b aË r                 | compound_indicators
merkbare                  | m É› r É¡ b aË r É™               | compound_indicators
merkbaren                 | m É› r É¡ b aË r É™               | compound_indicators
onverbreekbaren           | É” n v É™ r b r eË É¡ b aË r É™    | compound_indicators
weekdier                  | w eË É¡ d i r                   | compound_indicators
weekdieren                | w eË É¡ d i r É™                 | compound_indicators
wenkbrauw                 | w É› Å‹ É¡ b r É‘u w               | compound_indicators
wenkbrauwen               | w É› Å‹ É¡ b r É‘u w É™             | compound_indicators
zakdoek                   | z É‘ É¡ d u k                    | compound_indicators
zakdoeken                 | z É‘ É¡ d u k É™                  | compound_indicators

â“ MANUAL REVIEW STILL REQUIRED
==================================================
aardrijksbeschrijving     | aË r d r É›i É¡ z b É™ s x r É›i v Éª Å‹
blijkbaar                 | b l É›i É¡ b aË r
dekblad                   | d É› É¡ b l É‘ t
gueboroar                 | É¡ É™ b oË r oË É‘ r
guineesche                | É¡ i n eË s É™
onbereikbare              | É” m b É™ r É›i É¡ b aË r É™
ongenaakbaar              | É” Å‹ É£ É™ n aË É¡ b aË r
ongenaakbaarder           | É” Å‹ É£ É™ n aË É¡ b aË r d É™ r
ongenaakbare              | É” Å‹ É£ É™ n aË É¡ b aË r É™
onwrikbaar                | É” n w r Éª É¡ b aË r
onwrikbare                | É” n w r Éª É¡ b aË r É™
onwrikbaren               | É” n w r Éª É¡ b aË r É™
rijkbevolkte              | r É›i É¡ b É™ v É” l k t É™
rijkdommen                | r É›i É¡ d É” m É™
